NO ./assets/4.xpm
SO ./assets/4.xpm
WE ./assets/4.xpm
EA ./assets/4.xpm
F 0,0,0
C 0,0,0



         11111111111111111111
        1000000000000000000001
      11000000000000000000000011
    110000000000000000000000000011
  1100000000000000000000000000000011
11000000000000011111111000000000000011
11000000000000111    11100000000000011
11000000000000111    11100000000000011
11000000000000111    11100000000000011
11000000000000011111111000000000000011
 11000000000000000000000000000000011
   11000000000000000000000000000011
     1100000000000000000N00000011
       100000000000000000000001
        1111111111111111111111

