NO ./assets/1.xpm
SO ./assets/3.xpm
WE ./assets/2.xpm
EA ./assets/4.xpm
F 220,100,0
C 225,30,0



				11111111111
			   1100000000011
		1100000000000000000011111
	110000000000000000000000000011111
11000000000000011111111000000000000011111
1100000000000011