NO ./assets/tile131.xpm
SO ./assets/tile087.xpm
WE ./assets/door_blue.xpm
EA ./assets/tile095.xpm
F       50,         52,          00
C 10, 20, 25














111111111111111111111111111111111111111
100000000000000000000000000000000000001
100000000000000000000000000000000000001
1000000000000000000000000000000000000011111111111111111
10000000000000000000000000000000000001111111111111111111111111
11111111111111111111111110000000000000000000000000000000000001
100000000000000000000000000000000000000000000000000000000000111
100000000000000000000000000000000000000000000000000000000000001
100000000000000000000000N00000000000000000000000000000000000001
100000000000000000000000000000000000000000000001111111111111111
100000000000000000000000000000000000000000000001
100000000000000000000000000000000000000000000001
10000000000000000000000000000000000000000000001111111111111111
100000000000000000000000000000000000000000000000000000000000001
100000000000000000000000000000000000000000000001111111111111111
100000000000000000000000000000000000000000000000000000000000001
100000000000000000001111111111111000000000000000000000000000001
100000000000000000001111111111111000000000000001111111111111111
100000000000000000000111111111110000000000000001
100000000000000000000011111111100000000000000001
100000000000000000000001111111000000000000000001111111111111111
100000000000000000000000111110000000000000000000000000000000001
100000000000000000000000011100000000000000000000000000000000001
100000000000000000000000001000000000000000000000000000000000001
100000000000000000000000000000000000000000000000000000000000001
100000000000000000000000000000000000000000000011111111111111111
10000000000000000000000000000000000000000000001
10000000000000000000000000000000000000000000001
111111111111111111111111111111111111111111111111