

NO ./assets/4.xpm
SO ./assets/4.xpm
WE ./assets/4.xpm
EA ./assets/4.xpm

F  0,0,0

C 0 ,0 ,0

111111111111111111111111111
100000000000000000000000001
100000001000000000000000001
10000000000000S000000000001
111110000000000000000000001
100000000000000000000000001
111111111111111111111111111