

NO ./assets/1.xpm
SO ./assets/2.xpm
WE ./assets/3.xpm
EA ./assets/4.xpm




F 126,11,48
C 111,111,111
 
11111111111111111111111111
100000000000000000000000001        
100000001000000000000000001
10000000000000S000000000001
100000000000000000000000001
111110000000000000000000001
100000000000000000000000001
111111111111111111111111111



111111
111111
100001
111111